WWWWWWWWWWWWWWWWWWWWWWWWWWWWWWWWWWWWWWWWWWWWWWWWWWWWWWWWWWWWWWWW
WFFFFFFFFFFFFFFFFFFFFFFFFFFFFFFFFFFFFFFVFFFFFFFFFFVFFFFFFFFFFFFW
WFFFFFFFFFFFFBFFFFFFFFFFFFFFFFFFFFFFFFFFFFFFFFFFFFFFFFFFFFFFFFFW
WFFBFFFFFFFFFFFFFFFFFFFFFFFFFFFFFFFFFFFFFFFFFFFFFFFFFFFFFFFFFFFW
WFFFFFFFFFFFFFFFFFFFFFFFFFFFFFFFFFFFFFWWWWWWWWWWWWWWWWWWWFFFFFFW
WFFFFFFFFFFFFFFFFFFFFFFFFFFFFFFFFFFFFFWWWWWWWWWWFFFFVFFFFFFFFFFW
WFFFFFFFFFFFFFFFFFFFFFFFFFFFFTFFFFFFFFWWWWWWWWWWFFFFFFFFFFFFFFFW
WFFFFFFFFFFFFFFFFFFTFFFFFFFFFWWWWWWWWWWWWWWWWWWWFFFWWWWWWWWWWWWW
WFFFFFFFFTFFFFFFFFFWWWWWWWWWWWWWWWWWWWWWWWWWWWWWFFFFFFFFFFFFFFFW
WFGFFFFFFWWWWWWWWWWWWWWWWWWWWWWWWWWWWWWWWWWWWWWWFFFFFFFFFFFFFFFW
WWWWFFFFFFFVFFFFFFFFFFVFFFFFFFFFFVFFFFFFFFFFFFFWWWWWWFFFFFFFFFFW
WFFFFFFFFFFFFFFFFFFFFFFFFFFFFFFFFFFFFFFFFFFFFFFWWWWWWFFFFFFFFDFW
WFOFFHFFFFFFFFFFFFFFFFFFFFFFFFFFFFFFFFFFFFFFFFFWWWWWWFFFFFFFFFFW
WWWWWWWWWWWWWWWWWWWWWWWWWWWWWWWWWWWWWWWWWFFFFFFWWWWWWWWWWWWWWWWW
WFFFFFFFFFFFFVFFFFFFFFFFFFFFFFFFFFFFFFFFWWWFFFFFFFFFFFFFFFFFWWWW
WFFFFFFFFFFFFFFFFFFFFFFFFFFFFFFFFFFFFFFFFWWFFFFFFFFFFFFFFFFFWWWW
WFFFFTFFFFFFFFFFFFFFFFFFFFFFFFFFFFFFFFFFFWWFFFFFFFFFFFFFFFFFWWWW
WFFWWWWWWWWWWWWWWFFFBFFFFFFFFFFFFFFFFFFFFWWWWWWWWWWWWWWWFFFFWWWW
WFFWWWWWWWWWWWWWWFFFFFFFFFFFFFSSSSFFFFFFFFFFFFFFFFFFFFFFFFFFWWWW
WFFFFFFFFFFFWWWWWFFFFFFFFFFFFFWWWWFFFFFFFFFFFFFFFFFFFFFFFFFFWWWW
WWFFFFFFFFFFWWWWWFFFFFFFFFFFFFWWWWFFFFFFFFFFFFFFFFFFFFFFFFFFWWWW
WWWWWFFFFFFFWWWWWFFFFFFFFFFFFFWWWWFFFFFFFFFFFFFFFFFFFFFFFFFFWWWW
WWWWWWFFFFFFWWWWWFFFFFFFFFFFFFWWWWFFFFFFFFWWWWWWWWWWWWWWFFFFWWWW
WWWWWWWFFFFFWWWWWFFFFFFFFFFFFFWWWWFFFFFFFFFFFFFFFFFFFFVFFFFFWWWW
WFFFFFFFFFFFWWWWWFFFFFFFFFFFFFWWWWFFFFFFFFFFFFFFFFFFFFFFFFFFWWWW
WFFFFFFFFFFFWWWWWFFFFFFFFFLFFFWWWWFFFFFFFFFFFFFFFFFFFFFFFFFFWWWW
WFPFFFFFFFFFWWWWWFFFFFFWWWWWWWWWWWWWWWWWFFFTFFFFFFFFFFFFFFFLWWWW
WWWWWWWWWWWWWWWWWWWWWWWWWWWWWWWWWWWWWWWWWWWWWWWWWWWWWWWWWWWWWWWW
WWWWWWWWWWWWWWWWWWWWWWWWWWWWWWWWWWWWWWWWWWWWWWWWWWWWWWWWWWWWWWWW