WWWWWWWWWWWWWWWWWWWWWWWWWWWWWWWWWWWWWWWWWWWWWWWWWWWWWWWWWWWWWWWWWWWWWWWWWWWWWWWWWWWWWWWWWWWWWWWWWWWWWWWWWWWWWWWWWWWWW
WFFFFFFFFFFFFFFFFFFFFFFFFFFFFFBFFFFFFFFFFFFFFFFFFFFFFFFFFFFFFFFFFFFFBFFFFFFFFFFFFFFFFFFFWWFFFFFFFFFFFFFFFFBFFFFFFFFFW
WFFFFFFFFFFFFFFFFFFFFFFFFFFFFFFFFFFFFFFFFFFFFFFFFFFFFFFFFFFFFFFWWWFFFFFBFFFFFFFFFFFFFFFFWWFFFFFFFFFFFFFFFFFFFFFFFFDFW
WFFFFFFFFFFFFFFFFFFFFFFFFFFFFFFFFFFFFFFFFFFFFFFFFFFFFFFFFFFFFFFWWWFFFFFFFFFFFFFFFFFFFFFFWWFFFFFFFFFFFFFFFFFFFFFFFFFFW
WFFFFFFFFFFFFFFFFFFFFFFFFFFFFFFFFFFFFFFFFFFFFFFFFFFFFFFFFFFFFFFFFFFFFFFFFFFFFFFWWWWWFFFFFFFFFFFFFFFBFFFFFFFFFFFFWWWWW
WFFFFFFFFFFFFFFWWWWWWWWWWWWFFFFFFFWWWWWWWWWWTFFFFFFFFFFFFFFFFFFFFFFFFFFFFFFFFFFWWWWWFFFFFFFFFFFFFFFFFFFFFFFFFFFWWWWWW
WFFFFFFFHFFFFFFWWWWWWWWWWWWSSSSSSSWWWWWWWWWWWWWWWWWWWWWWWWWWFFFFFFTFFFFFFFFFFFFWWWWWFFFFFFFFFFFFFFTFFFFFFFFFFFWWWWWWW
WFFFFFFWWWWWWWWWWWWWWWWWWWWWWWWWWWWWWWWWWWWWWWWWWWWWWWWWWWWWWWWWWWWWWWWWWWWWWWWWWWWWWWWWWWWWWWWWWWWWWWWWWWWWWWWWWWWWW
WFFFFFFWWWWWWWWWWWWWWWWWWWWWWWWWWWWWWWWWWWWWWWWWWWWWWWWWWWWWWWWWWWWWWWWWWWWWWWWWWWWWWWWWWWWWWWWWWWWWWWWWWWWWWWWWWWWWW
WFFFFFFFFFFBFFFFFFFFFFFFFFFFFFFFFFFFFFFFFFFFFFFFFFFFFFFFFFFFFFFFFFFFFFFFFFFFFFFFFFFFFFWWFFFFFFFFFFFFFFFFFFFFFFFFFFFFW
WFFFFFFFFFBFFFFFFFFFFFFFFFFFFFFFFFFFFFFFFFFFFFFFFFFFFFFFFFFFFFBFFFFFFFFFFFFFFFFFFFFFFFWWFBFFFFFFFFFFFFFFFFFFFFFFFFFFW
WWWWWWFFFBFFFFFFFFFFFFFFFFFFFFFFFFFWWWWWFFFHFFFFFFFFFFFFFFFFFFFFFFFFFFFFFFFFFFFFFFFFFFWWFFFWWFFFFFFFFFFFFFFFFFFFFFFFW
WWWWWWFFFFFFFFFFFFFFFFFFFFFFFFFFFFFWWWWWWWFFFFFFFFFFFFFFFFFFFFFFFFFFFFFFFFFFFFFFFFFFFFFFFFFWWFFFFFFFFFFFFFFFFFFFFFFFW
WWWWWWFTFFFFFFFFFFFFFFFFFFFFFFFFFFFWWWWWWWWWWWWWWWWWWWWTFFFFFFFFFFFFFFFFFFFFFFFFFFFFFFFFFFFWWTFFFFFFFFFFFFFFFFFFFFFFW
WWWWWWWWWWWWWWWWWWWWWWWWWWWWWWWWWWWWWWWWWWWWWWWWWWWWWWWWWWWWWWWWWWWWWWWWSSSSSSWWWWWWWWWWWWWWWWWWWWWWWWWWFIFFFFFFFFFFW
WWWWWWWWWWWWWWWWWWWWWWWWWWWWWWWWWWWWWWWWWWWWWWWWWWWWWWWWWWWWWWWWWWWWWWWWWWWWWWWWWWWWWWWWWWWWWWWWWWWWWWWWWWWFFFFFFFFFW
WFFFFFFFFFFFFFFFFFFFFFFFFFFFFFFFFFFFFFFFFFFFFFFFFFFFFFFFFFFFFFFFFFFFFFFFFFFFFFFFFFFWWFFFFFFFFFFFFFFFFFFFFFFFFFFWWWWWW
WFFFFFFFFFFFFFFFFFFFFFFFFFFFFFFFFFFFFFFFFFFFFFFFFFFFFFFFFFFFFFFFFFFFFFFFFFFFFFFFFBFWWFFFFFFFFFFFFFFFFFFFFFFHFFFWWWWWW
WFFFFFFFFFFFFFFFFFFFFFFFFFFFFFFFFFFFBFFFFFFFFFFFFFFFFFFFFFFFFFTFFFFFFFFFFFFFFFFFFFFWWFFFFFFFFFFFBFFFFFWWWWWWWWWWWWWWW
WFFFFFFFFFFFFFFFFFFFFFFFFFFFFFFFFFFFFFFFFFFFFFFFFFFFFFFFFWWWWWWWWWWWWWWWWWWWWWWWFFFWWFFFFFFFFFFFFFFFWWWWWWWWWWWWWWWWW
WFFFFFFFFFFFFFFFFFFFFFFFFFFFFFFFFFFFFFFTFFFFFFFFFFFFFFHFWWWFFFFFFFFFFFFFFFFFFFFFFFFWWFFFFFFFFFFFFFFFFFFFFFFFFFFWWWWWW
WFFFFFFFFFFFFFFFFFFFFFFFFFFFFFFFFFFFFFFWWWWWWWWWWWWWWWWWWWWFBFFFFFFFFFFFFFFFFFFFFFFWWWWWWWWFFFFFFFFFFFFFFFFFFFFWWWWWW
WFFFFFFFFFFFFFFFFFFFFFFFFFFFFFFFFFFFFFFFFFFFFFFFFFFFFWWFFFFFFFFWWWWWWWWWWWWWWWWWWWWWWFFFFFFFFFFFFFFFFFFFFFFFFFFWWWWWW
WFFFFFFFFFFFFFFFFFFFFFFFWWWWWWWWWFFFFFFFFFFFFFFFFFFFFWWFFFFFFFFWWWWWWWWWWWWWWWWWWWWWWFFFFFFFFTFFFFFFFFFFFFFFFFFWWWWWW
WFFFFFFFFFFFFFFFFFFFFFFFFFFFFFFFFFFFFFFFFFFFFFFFFFFFFWWFFFFFFFFWWWFFFFFFFFFFFFFFFFFFFFFFFFFFFWWWWWWWWWWWFFFFFFFWWWWWW
WFFFFFFFFFFFFFFFFFFFFFFFFFFFFFFFFFFFFFFWWWWWFFFFFFFFFWWWWWWFFFFWWWFFFFFFFFFFFFFFFFFFFFFFFFFFFFFFFFFFFFFFFFFFWWWWWWWWW
WFFFFFFFFFFFFFFFFFFFFFFFFFFFFFFFFFFFFFFFFFFFBFFFFFFFFWWFFFFFFFFWWWFFFFFFFFFFFFFFFFFWWFFFFFFFFFFFFFFFFFBFFFFFWWWWWWWWW
WFFFFFFFFFFFFFFFFWWWWWWWWWFFFFFFFFFFFFFFFFFFFFFWWWWWWWWFFFFFFFFWWWFFFFFFFFFWWWWWWWWWWFFFFFFFFFFFFFFFFFFFFFWWWWWWWWWWW
WFFFFFFWWWWWFFFFFFFFFFFFFFFFFFFFFFFFFFFFFFFFFFFFFFFFFWWFFFFFFFFFFFFFFFFFFFFFFFFFFFFWWFFFFFFFFTFFFFFFFFWWWWWWWWWWWWWWW
WFPFFFFWWWWWFFFFFFFFFFFTFFFFFFWWWWWWFFFFFFFFFFFFFFFFFWWTFFFFFFFFFFFFFFFFFFFFFFFFFFFWWWWWWWWWWWWWWWWWWWWWWWWWWWWWWWWWW
WWWWWWWWWWWWWWWWWWWWWWWWWWWWWWWWWWWWWWWWWWWWWWWWWWWWWWWWWWWWWWWWWWWWWWWWWWWWWWWWWWWWWWWWWWWWWWWWWWWWWWWWWWWWWWWWWWWWW
WWWWWWWWWWWWWWWWWWWWWWWWWWWWWWWWWWWWWWWWWWWWWWWWWWWWWWWWWWWWWWWWWWWWWWWWWWWWWWWWWWWWWWWWWWWWWWWWWWWWWWWWWWWWWWWWWWWWW