WWWWWWWWWWWWWWWWWWWWWWWWWWWWWWWWWWWWWWWWWWWWWWWWWWWWWWWWWWWWWWWWWWWWWWWWWWWWWWWWWWW
WFFFFFFFFFFFFFFFFFFFFFFFFFFFFFFFFBFFFFWWFFFFFFFFFFFFFFFFFFFFFFFFFFFFFFFFFFFFFFFFFFW
WFFFFFFFFFFFFFFFFFFFFFFFFFFFFFFFFFFFFFWWFFFFFFFFFBFFFFFFFFFFFFFFFFFFFFFFFFFFFFFFFFW
WFFFFFFFFFFFFFFFFFFFFFFFFFBFFFFFFFFFFFFFFFFFFFFFFFFFFFFFFFFFFFFBFFFFFFFFFFFFFFFFFFW
WFFFFFFFFFFFFFFFFFFFFFFFFFFFFFFFFFWWWWWWWWWWFFFFFFFFFFFFFFFFFFFFFFFFFFBFFFFFFFFFFFW
WFPFFFFFFTFFFFFFFFFFFFFFFFFFFFFFFFWWWWFFFFFFFFFFFFFFWWWFFFFFFFFFFFFFFFFFFFFFFFFFBFW
WWWWWWWWWWWWWWWWWWWWWWWWWFFFFFFFFFWWWWFFFFFFFFFFFFFWWWWFFFTFFFFFFFFFFFFFFFFFFFFFFFW
WWWWWFFFFFFFFFFFFFFFFFFFWFFFFFFFFFWWWWFFGFFFFFFFFFFWWWWWWWWWWWWWWWWWWWWWWWWWFFFFFFW
WWWWWFFFFFFFFFOFFFFFFFFFWSSSSSSSSSWWWWFFFFFFFFFFFFFWFFFFFFFFFFFFFFFFFBFFFFFFFFFFFFW
WWWWWFFFFFFFFFFFFFFFFFFFWWWWWWWWWWWWWWWWWWWWSSSSSSSWFFFFFFFFFFFFFFFFFFFFFFFFFFFFFFW
WWWWWFFFFFWWWWWWWWWWFFFFFFFFFFFFFFFFFFFFFBFWWWWWWWWWFFFFFFWWWWWWWWFFFFFFFFFFFFFHFFW
WWWWWFFFFFFFFFFFFFFFFFFFFFFFFFFFFFFFFFFFFFFFFFFFFFFFFFFFFFFFFFFFFFFFFFFFFFWWWWWWWWW
WWWWWFFFFFFFFFFFFFFFFFFFTFFFFFFFFFFFFFFFFFFFFFFFFFFFFFFFFFFFFFFFFFFFFFFFFFFFFFFFFFW
WWWWWFFFFFFFFFFFFFFFFFFFWWWWWWWWWWWWFFFFFFFFFFFFWWWWWWWWFFFFFFFFFFFFFFFFFFFFFFFFFFW
WWWWWFFFFFFFFFFFFFFFFFFFFFFFFFFFFFFFFFFFFFFFFFWWWWWWWWWWFFFFFFFFFFFFFFFFFFFFFFFFFFW
WWWWWFFFFFFFFFFFFFFFFFFFFFFFFFFFFFFFFFFFFFFFFFFFFFFFFFFFFFFFFFFFFFFLFFFFFFFFFFFFFFW
WWWWWFFFFFFFFFFFFFFFFFFFFFFFFFFFFFFFFFFLFFFFFFFFFFFFFFFFFFFFFFFFFFFWWWWWWFFFFFFFFFW
WWWWWFFFFFWWWWWWWWWWFFFFFFFFFFFFFFFFFFFWWWWWWFFFFFFFFFFFFFFFFFFFFFFFFFFFFFFFFFFFFFW
WWWWWFFFFFFFFFFFFFFFFFFFFFFFFFFFFFFFFFFFFFFFFFFFFFFFFFFFFFFFFFFFFFFFFFFFFFFFFFFFFFW
WWWWWFFFFFFFFFFFFFFFFFFFFFFFFFFFFFFFFFFFFFFFFFFFFFFFFFFFFFFFFFFFFFFFFFFFFFFFFFFFFFW
WWWWWFFFFFFFFFFFFFFFFFFFFFFFFFFFFFFFFFFFFFFFFFFFFFFBFFFFFFFFFFFFFFFFFFFFFFFFFFFFFFW
WWWWWWWWWFFFFFFFFBFFFFFFFFFFFFFFFFFFFFFFFFFFFFFFFFFFFFFFFFFFFFFFFFFFFFFFFFFFFFFFFFW
WWWWWFFFFFFFFFFFFFFFFFFFFFFFFFFFFFFFFFFFBFFFFFFFFFFFFFFFFFFFFFFFFFFFFFFFFFFFFFFFFFW
WWWWWFFFFFFFFFFFFFFFFFFFFFFFFFFFFFFFFFFFFFFFFFFFFFFFFFFFFFFFFFFFFFFFFFFFBFFFFFFFFFW
WWWWWFFFFFFFFBFFFFFFFFFFTFFFFFFFFFFFFFFFFFFFFFFFFFFFFFFFFBFFFFFFFFFFFFFFFFFFFFFFFFW
WWWWWFFFFFFFFFFFFFFFFFFFWWWWWWWWWWWWFFFFFFFFFFFFFFFFFFFFFFFFFFFFFFFFFFFFFFFFFFFFFFW
WWWWWFFFFFFFFFFFFFFFFFFFFFFFFFFFFFFFFFFFFFFFWWWWWWWWWFFFFFFFFFFFFFFFFFFFFFFFFFFDFFW
WWWWWFFFFWWWWWWWFFFFFFFFFFFFFFFFFFFFFFFFFFFFFFFFFFFFFFFFFFFFFWWWWWWWFFFFFFFFFFFFFFW
WWWWWFFFFFFFFFFFFFFFFFFFFFFFFFFFFFFFFFFFFFFFFFFFFFFFFFFFFFFFFFFFFFFFFFFFFFFFWWWWWWW
WWWWWSSSSSSSSSSSSSSSSSSSSSSSSSSSSSSSSSSSSSSSSSSSSSSSSSSSSSSSSSSSSSSSSSSSSSSSWWWWWWW
WWWWWWWWWWWWWWWWWWWWWWWWWWWWWWWWWWWWWWWWWWWWWWWWWWWWWWWWWWWWWWWWWWWWWWWWWWWWWWWWWWW